What do you want to eat tonight?	¿Qué quieres comer esta noche? ... ¿Qué quieres comer esta noche? ... ¿Qué quieres comer esta noche? ... ¿Qué quieres comer esta noche? ... ¿Qué quieres comer esta noche? ... ¿Qué quieres comer esta noche? ... 
Why are there so many people here?	¿Por qué hay tanta gente aquí? ... ¿Por qué hay tanta gente aquí? ... ¿Por qué hay tanta gente aquí? ... ¿Por qué hay tanta gente aquí? ... ¿Por qué hay tanta gente aquí? ... ¿Por qué hay tanta gente aquí? ... 
Where is the port?	¿Dónde está el puerto? ... ¿Dónde está el puerto? ... ¿Dónde está el puerto? ... ¿Dónde está el puerto? ... ¿Dónde está el puerto? ... ¿Dónde está el puerto? ... 
When is the market opening?	¿Cuándo abre el mercado? ... ¿Cuándo abre el mercado? ... ¿Cuándo abre el mercado? ... ¿Cuándo abre el mercado? ... ¿Cuándo abre el mercado? ... ¿Cuándo abre el mercado? ... 
Who is going out tonight?	¿Quién quiere salir esta noche? ... ¿Quién quiere salir esta noche? ... ¿Quién quiere salir esta noche? ... ¿Quién quiere salir esta noche? ... ¿Quién quiere salir esta noche? ... ¿Quién quiere salir esta noche? ... 
How do you want to pay?	¿Cómo quiere pagar? ... ¿Cómo quiere pagar? ... ¿Cómo quiere pagar? ... ¿Cómo quiere pagar? ... ¿Cómo quiere pagar? ... ¿Cómo quiere pagar? ... 
Which one of these is your car?	¿Cuál de estos es tu automóvil? ... ¿Cuál de estos es tu automóvil? ... ¿Cuál de estos es tu automóvil? ... ¿Cuál de estos es tu automóvil? ... ¿Cuál de estos es tu automóvil? ... ¿Cuál de estos es tu automóvil? ... 
How much pasta do we need to cook for eight people?	¿Cuánta pasta necesitamos cocinar para ocho personas? ... ¿Cuánta pasta necesitamos cocinar para ocho personas? ... ¿Cuánta pasta necesitamos cocinar para ocho personas? ... ¿Cuánta pasta necesitamos cocinar para ocho personas? ... ¿Cuánta pasta necesitamos cocinar para ocho personas? ... ¿Cuánta pasta necesitamos cocinar para ocho personas? ... 
How many days are you staying here?	¿Cuántos días te quedarás aquí? ... ¿Cuántos días te quedarás aquí? ... ¿Cuántos días te quedarás aquí? ... ¿Cuántos días te quedarás aquí? ... ¿Cuántos días te quedarás aquí? ... ¿Cuántos días te quedarás aquí? ... 
Yes, I like Peruvian music very much	Sí, me gusta mucho la música peruana ... Sí, me gusta mucho la música peruana ... Sí, me gusta mucho la música peruana ... Sí, me gusta mucho la música peruana ... Sí, me gusta mucho la música peruana ... Sí, me gusta mucho la música peruana ... 
No, we can not do anything.	No, no podemos hacer nada. ... No, no podemos hacer nada. ... No, no podemos hacer nada. ... No, no podemos hacer nada. ... No, no podemos hacer nada. ... No, no podemos hacer nada. ... 
No, I do not like rainy days	No, no me gustan los días lluviosos ... No, no me gustan los días lluviosos ... No, no me gustan los días lluviosos ... No, no me gustan los días lluviosos ... No, no me gustan los días lluviosos ... No, no me gustan los días lluviosos ... 
Have. We have to stay here.	Tener. Tenemos que quedarnos aquí. ... Tener. Tenemos que quedarnos aquí. ... Tener. Tenemos que quedarnos aquí. ... Tener. Tenemos que quedarnos aquí. ... Tener. Tenemos que quedarnos aquí. ... Tener. Tenemos que quedarnos aquí. ... 
Unfortunately, we don't have an alternative.	Desafortunadamente, no tenemos alternativa. ... Desafortunadamente, no tenemos alternativa. ... Desafortunadamente, no tenemos alternativa. ... Desafortunadamente, no tenemos alternativa. ... Desafortunadamente, no tenemos alternativa. ... Desafortunadamente, no tenemos alternativa. ... 
Perhaps we could stay in and watch a movie tonight	Tal vez podemos quedarnos y ver una película esta noche ... Tal vez podemos quedarnos y ver una película esta noche ... Tal vez podemos quedarnos y ver una película esta noche ... Tal vez podemos quedarnos y ver una película esta noche ... Tal vez podemos quedarnos y ver una película esta noche ... Tal vez podemos quedarnos y ver una película esta noche ... 
Maybe it will rain tomorrow	Quizá llueva mañana ... Quizá llueva mañana ... Quizá llueva mañana ... Quizá llueva mañana ... Quizá llueva mañana ... Quizá llueva mañana ... 
Sure! I will go on a hike with you!	¡Claro! ¡Iré de excursión contigo! ... ¡Claro! ¡Iré de excursión contigo! ... ¡Claro! ¡Iré de excursión contigo! ... ¡Claro! ¡Iré de excursión contigo! ... ¡Claro! ¡Iré de excursión contigo! ... ¡Claro! ¡Iré de excursión contigo! ... 
of course	por supuesto ... por supuesto ... por supuesto ... por supuesto ... por supuesto ... por supuesto ... 
Of course I paid: here is the receipt	Por supuesto que he pagado: aquí está el recibo ... Por supuesto que he pagado: aquí está el recibo ... Por supuesto que he pagado: aquí está el recibo ... Por supuesto que he pagado: aquí está el recibo ... Por supuesto que he pagado: aquí está el recibo ... Por supuesto que he pagado: aquí está el recibo ... 
I am Pedro; I am the hotel’s manager	Soy Pedro; soy el gerente del hotel ... Soy Pedro; soy el gerente del hotel ... Soy Pedro; soy el gerente del hotel ... Soy Pedro; soy el gerente del hotel ... Soy Pedro; soy el gerente del hotel ... Soy Pedro; soy el gerente del hotel ... 
Are you Venezuelan as well?	¿Tú también eres venezolano? ... ¿Tú también eres venezolano? ... ¿Tú también eres venezolano? ... ¿Tú también eres venezolano? ... ¿Tú también eres venezolano? ... ¿Tú también eres venezolano? ... 
Currently, I am working in a law firm in Barcelona	Actualmente, estoy trabajando en un estudio de abogados en Barcelona ... Actualmente, estoy trabajando en un estudio de abogados en Barcelona ... Actualmente, estoy trabajando en un estudio de abogados en Barcelona ... Actualmente, estoy trabajando en un estudio de abogados en Barcelona ... Actualmente, estoy trabajando en un estudio de abogados en Barcelona ... Actualmente, estoy trabajando en un estudio de abogados en Barcelona ... 
you are	estás ... estás ... estás ... estás ... estás ... estás ... 
My name is Valeria	Me llamo Valeria ... Me llamo Valeria ... Me llamo Valeria ... Me llamo Valeria ... Me llamo Valeria ... Me llamo Valeria ... 
What is your name?	¿Cómo te llamas? ... ¿Cómo te llamas? ... ¿Cómo te llamas? ... ¿Cómo te llamas? ... ¿Cómo te llamas? ... ¿Cómo te llamas? ... 
I have a house in Madrid	Tengo una casa en Madrid ... Tengo una casa en Madrid ... Tengo una casa en Madrid ... Tengo una casa en Madrid ... Tengo una casa en Madrid ... Tengo una casa en Madrid ... 
I have to buy some things	Tengo que comprar algunas cosas ... Tengo que comprar algunas cosas ... Tengo que comprar algunas cosas ... Tengo que comprar algunas cosas ... Tengo que comprar algunas cosas ... Tengo que comprar algunas cosas ... 
I [really] like this dress.	Encantar. Me encanta ese vestido. ... Encantar. Me encanta ese vestido. ... Encantar. Me encanta ese vestido. ... Encantar. Me encanta ese vestido. ... Encantar. Me encanta ese vestido. ... Encantar. Me encanta ese vestido. ... 
How many dresses do you have?	¿Cuántos vestidos tienes? ... ¿Cuántos vestidos tienes? ... ¿Cuántos vestidos tienes? ... ¿Cuántos vestidos tienes? ... ¿Cuántos vestidos tienes? ... ¿Cuántos vestidos tienes? ... 
Every year I go to visit my family in Costa Rica	Todos los años voy a visitar a mi familia en Costa Rica ... Todos los años voy a visitar a mi familia en Costa Rica ... Todos los años voy a visitar a mi familia en Costa Rica ... Todos los años voy a visitar a mi familia en Costa Rica ... Todos los años voy a visitar a mi familia en Costa Rica ... Todos los años voy a visitar a mi familia en Costa Rica ... 
Are you going to the supermarket? I'll come with you.	¿Vas al supermercado? Iré contigo. ... ¿Vas al supermercado? Iré contigo. ... ¿Vas al supermercado? Iré contigo. ... ¿Vas al supermercado? Iré contigo. ... ¿Vas al supermercado? Iré contigo. ... ¿Vas al supermercado? Iré contigo. ... 
I'll come with you if you want.	Iré contigo si quieres. ... Iré contigo si quieres. ... Iré contigo si quieres. ... Iré contigo si quieres. ... Iré contigo si quieres. ... Iré contigo si quieres. ... 
No, I'll not come with you.	No, no iré contigo. ... No, no iré contigo. ... No, no iré contigo. ... No, no iré contigo. ... No, no iré contigo. ... No, no iré contigo. ... 