¿Qué quieres comer esta noche?	What do you want to eat tonight?
¿Por qué hay tanta gente aquí?	Why are there so many people here?
¿Dónde está el puerto?	Where is the port?
¿Cuándo abre el mercado?	When is the market opening?
¿Quién quiere salir esta noche?	Who is going out tonight?
¿Cómo quiere pagar?	How do you want to pay?
¿Cuál de estos es tu automóvil?	Which one of these is your car?
¿Cuánta pasta necesitamos cocinar para ocho personas?	How much pasta do we need to cook for eight people?
¿Cuántos días te quedarás aquí?	How many days are you staying here?
Sí, me gusta mucho la música peruana	Yes, I like Peruvian music very much
No, no podemos hacer nada.	No, we can not do anything.
No, no me gustan los días lluviosos	No, I do not like rainy days
Tener. Tenemos que quedarnos aquí.	Have. We have to stay here.
Desafortunadamente, no tenemos alternativa.	Unfortunately, we don't have an alternative.
Tal vez podemos quedarnos y ver una película esta noche	Perhaps we could stay in and watch a movie tonight
Quizá llueva mañana	Maybe it will rain tomorrow
¡Claro! ¡Iré de excursión contigo!	Sure! I will go on a hike with you!
por supuesto	of course
Por supuesto que he pagado: aquí está el recibo	Of course I paid: here is the receipt
Soy Pedro; soy el gerente del hotel	I am Pedro; I am the hotel’s manager
¿Tú también eres venezolano?	Are you Venezuelan as well?
Actualmente, estoy trabajando en un estudio de abogados en Barcelona	Currently, I am working in a law firm in Barcelona
estás	you are
Me llamo Valeria	My name is Valeria
¿Cómo te llamas?	What is your name?
Tengo una casa en Madrid	I have a house in Madrid
Tengo que comprar algunas cosas	I have to buy some things
Encantar. Me encanta ese vestido.	I [really] like this dress.
¿Cuántos vestidos tienes?	How many dresses do you have?
Todos los años voy a visitar a mi familia en Costa Rica	Every year I go to visit my family in Costa Rica
¿Vas al supermercado? Iré contigo.	Are you going to the supermarket? I'll come with you.
Iré contigo si quieres.	I'll come with you if you want.
No, no iré contigo.	No, I'll not come with you.